uint8_t Level_00[] = {
{ 0, 0,  0, 0,  0, 0,  0, 0,  0, 0,  0, 0,  0, 0, 64,64, 74,74, 74,74, 74,74, 64,64, 74,74, 74,74, 74,74, 64,64, 74,74, 74,74, 74,74, 64,64, 74,74, 74,74, 74,74,  1, 1,  0, 0,},
{ 0, 0,  0, 0,  0, 0,  0, 0,  0, 0,  0, 0,  0, 0, 64,64, 74,74, 74,74, 74,74, 64,64, 74,74, 74,74, 74,74, 64,64, 74,74, 74,74, 74,74, 64,64, 74,74, 74,74, 74,74,  2, 2,  0, 0,},
{ 0, 0,  0, 0,  0, 0,  0, 0,  0, 0,  0, 0,  0, 0,  0, 0,  0, 0,  0, 0,  0, 0,  0, 0, 33,33,  0, 0,  0, 0,  0, 0,  0, 0,  0, 0,  0, 0, 33,33,  0, 0, 33,33,  0, 0,  0, 0,  0, 0,},
{ 0, 0,  0, 0,  0, 0,  0, 0,  0, 0,  0, 0,  0, 0,  0, 0,  0, 0,  0, 0,  0, 0,  0, 0, 31,31,  0, 0,  0, 0,  0, 0,  0, 0,  0, 0,  0, 0, 31,31,  0, 0, 31,31,  0, 0,  0, 0,  0, 0,},
{ 0, 0,  0, 0,  0, 0,  0, 0,  0, 0,  0, 0,  0, 0,  0, 0,  0, 0,  0, 0,  0, 0,  0, 0, 31,31, 64,64, 74,74, 74,74, 74,74, 62,62, 72,72, 31,31,  0, 0, 31,31,  0, 0,  0, 0,  0, 0,},
{ 0, 0,  0, 0,  0, 0,  0, 0,  0, 0,  0, 0, 29, 0,  0, 0,  0,30,  0, 0,  0, 0,  0, 0, 31,31, 64,64, 74,74, 74,74, 74,74, 62,62, 72,72, 31,31,  0, 0, 31,31,  0, 0,  0, 0,  0, 0,},
{ 0, 0,  0, 0,  0, 0,  0, 0, 62,62, 72,72,  0, 0,  0, 0,  0, 0, 63,63, 73,73, 73,73, 31,31,  0, 0,  0, 0,  0, 0,  0, 0, 33,33,  0, 0, 31,31,  0, 0, 31,31,  0, 0,  0, 0,  0, 0,},
{ 0, 0,  0, 0,  0, 0,  0, 0, 62,62, 72,72,  0, 0,  0, 0,  0, 0, 63,63, 73,73, 73,73, 31,31,  0, 0,  0, 0,  0, 0,  0, 0, 31,31,  0, 0, 31,31,  0, 0, 32,32,  0, 0,  0, 0,  0, 0,},
{ 0, 0,  0, 0,  0, 0,  0, 0,  0, 0, 33,33,  0, 0,  0, 0,  0, 0,  0, 0,  0, 0,  0, 0, 31,31,  0, 0,  0, 0,  0, 0,  0, 0, 31,31,  0, 0, 31,31,  0, 0,  0, 0,  0, 0,  4, 5,  0, 0,},
{ 0, 0,  0, 0,  0, 0,  0, 0,  0, 0, 31,31,  0, 0,  0, 0,  0, 0,  0, 0,  0, 0,  0, 0, 32,32,  0, 0,  0, 0,  0, 0,  0, 0, 31,31,  0, 0, 32,32,  0, 0,  0, 0,  0, 6,  1, 2,  0, 0,},
{ 0, 0,  0, 0,  0, 0,  0, 0,  0, 0, 31,31,  0, 0,  0, 0,  0, 0,  0, 0,  0, 0,  4, 5,  1, 1,  9,10,  0, 0,  0, 0,  0, 0, 31,31,  0, 0,  0, 0,  0, 0,  0, 0, 62,62, 72,72,  0, 0,},
{ 0, 0,  0, 0,  0, 0,  0, 0,  0, 0, 31,31,  0, 0,  0, 0,  0, 0,  0, 0,  0, 6,  1, 2,  2, 2,  2, 1, 11, 0,  0, 0,  0, 0, 32,32,  0, 0,  0, 0,  0, 0,  0, 0, 62,62, 72,72,  0, 0,},
{ 0, 0,  0, 0,  0, 0,  0, 0,  0, 0, 31,31,  0, 0,  0, 0,  0, 0,  4, 5, 64,64, 74,74, 74,74, 74,74,  1, 1,  9,10,  0, 0,  0, 0,  0, 0,  0, 0,  0, 0,  0, 0, 26,26,  0, 0,  0, 0,},
{ 0, 0,  0, 0,  0, 0,  0, 0,  0, 0, 32,32,  0, 0,  0, 0,  0, 6,  1, 2, 64,64, 74,74, 74,74, 74,74,  2, 2,  2, 1, 11, 0,  0, 0,  0, 0,  0, 0,  0, 0,  0, 0, 26,26,  0, 0,  0, 0,},
{ 0, 0,  4, 5,  0, 0,  9,10,  0, 0,  0, 0,  0, 0,  4, 5, 64,64, 74,74, 74,74, 74,74, 64,64, 74,74, 74,74, 74,74,  1, 1,  9,10,  0, 0,  0, 0,  0, 0,  4, 5, 62,62, 72,72,  0, 0,},
{ 0, 6,  1, 2, 38,38,  2, 1, 11, 0,  0, 0,  0, 6,  1, 2, 64,64, 74,74, 74,74, 74,74, 64,64, 74,74, 74,74, 74,74,  2, 2,  2, 1, 11, 0,  0, 0,  0, 6,  1, 2, 62,62, 72,72,  0, 0,},
};

uint16_t Level_00_Items[] = {
0,                             // ItemType::Key1
208,                             // Position X
80,                             // Position Y
0,                             // Frame
0,                             // Data
0,                             // Counter

14,                             // ItemType::LockedDoor
496,                             // Position X
16,                             // Position Y
0,                             // Frame
0,                             // Data
0,                             // Counter

41,                             // ItemType::Chakana
512,                             // Position X
16,                             // Position Y
9,                             // Frame
0,                             // Data
0,                             // Counter

18,                             // ItemType::Swinging_Vine
240,                             // Position X
96,                             // Position Y
0,                             // Frame
0,                             // Data
0,                             // Counter

63,                             // ItemType::Puff
0,                             // Position X
0,                             // Position Y
255,                             // Frame
0,                             // Data
0,                             // Counter
};

uint16_t Level_00_Enemies[] = {
0                            // EnemyType::None
0,                             // Position X
0,                             // Position Y
0,                             // Stance::Enemy_None
0,                             // Inventory ItemType::None

0                            // EnemyType::None
0,                             // Position X
0,                             // Position Y
0,                             // Stance::Enemy_None
0,                             // Inventory ItemType::None

0                            // EnemyType::None
0,                             // Position X
0,                             // Position Y
0,                             // Stance::Enemy_None
0,                             // Inventory ItemType::None

0                            // EnemyType::None
0,                             // Position X
0,                             // Position Y
0,                             // Stance::Enemy_None
0,                             // Inventory ItemType::None
};

uint16_t Level_00_PlayerStart[] = {
0,
0,
107,
};