uint8_t Level_00[] = {
{ 0, 5,  1, 1,  0, 0,  0, 0,  0, 0,  0, 0,  0, 0,  0, 0,  0, 0,  0, 0,  1, 1,  1, 1,  1, 1,  2, 2,  1, 1,  9, 0,  0, 0,  0, 0,  4, 5, 18,18,  2, 2,  2, 2,  1, 1,  0, 0,  0, 0,},
{ 6, 2,  2, 2,  0, 0,  0, 0,  0, 0,  0, 0,  0, 0,  0, 0,  0, 0,  0, 0,  2, 2,  2, 2,  2, 2,  49, 49,  2, 2,  2,11,  0, 0,  0, 0,  1, 2, 18,18,  50, 50,  51, 51,  2, 2,  0, 0,  0, 0,},
{ 0, 0,  0, 0,  0, 0,  0, 0,  0, 0,  0, 0,  0, 0,  0, 0,  0, 0,  0, 0, 33,33,  0, 0,  0, 0,  0, 0,  0, 0,  0, 0, 33,33,  0, 0,  0, 0,  0, 0,  0, 0,  0, 0,  0, 0,  0, 0,  0, 0,},
{ 0, 0,  0, 0,  0, 0,  0, 0,  0, 0,  0, 0,  0, 0,  0, 0,  0, 0,  0, 0, 31,31,  0, 0,  0, 0,  0, 0,  0, 0,  0, 0, 31,31,  0, 0,  0, 0,  0, 0,  0, 0,  0, 0,  0, 0,  0, 0,  0, 0,},
{ 0, 0,  0, 0,  0, 0,  0, 0,  0, 0,  0, 0,  0, 0,  0, 0,  0, 0,  0, 0, 31,31,  1, 1,  1, 1,  1, 1,  1, 1,  1, 1, 31,31,  1,19,  0, 0,  0, 0,  0, 0,  0, 0,  0, 0,  0, 0,  0, 0,},
{ 0, 0,  0, 0,  0, 0,  0, 0,  0, 0, 29, 0,  0, 0,  0,30,  0, 0,  0, 0, 31,31,  2, 2,  2, 2,  2, 2,  2, 2,  2, 2, 31,31,  2, 2,  0, 0,  0, 0,  0, 0,  0, 0,  0, 0,  0, 0,  0, 0,},
{ 0, 0,  0, 0,  0, 0,  0, 0,  0, 0,  0, 0,  0, 0,  0, 0,  1, 1,  1, 1, 31,31,  0, 0,  0, 0,  0, 0,  0, 0,  0, 0, 31,31,  0, 0,  0, 0,  0, 0,  0, 0,  0, 0,  0, 0,  0, 0,  0, 0,},
{ 0, 0,  0, 0,  0, 0,  0, 0,  0, 0,  0, 0,  0, 0,  0, 0,  2, 2,  2, 2, 31,31,  0, 0,  0, 0,  0, 0,  0, 0,  0, 0, 31,31,  0, 0,  0, 0,  0, 0,  0, 0,  0, 0,  0, 0,  0, 0,  0, 0,},
{ 0, 0,  0, 0,  0, 0,  0, 0,  0, 0,  0, 0,  0, 0,  0, 0,  0, 0,  0, 0, 31,31,  0, 0,  0, 0,  0, 0,  0, 0,  0, 0, 31,31,  0, 0,  0, 0,  0, 0,  0, 0,  0, 0,  0, 0,  0, 0,  0, 0,},
{ 0, 0,  0, 0,  0, 0,  0, 0,  0, 0,  0, 0,  0, 0,  0, 0,  0, 0,  0, 0, 32,32,  0, 0,  0, 0,  0, 0,  0, 0,  0, 0, 32,32,  0, 0,  0, 0,  0, 0,  0, 0,  0, 0,  0, 0,  0, 0,  0, 0,},
{ 1, 1,  0, 0,  1, 1,  0, 0,  1, 1,  0, 0,  1, 1,  0, 0,  0, 0,  0, 0,  2, 2,  2,11,  0, 0,  0, 0,  0, 0,  0, 0,  0, 0,  0, 0,  0, 0,  2, 2,  2, 2,  2, 2,  2, 2,  0, 0,  0, 0,},
{ 2, 2,  0, 0,  2, 2,  0, 0,  2, 2,  0, 0,  2, 2,  0, 0,  0, 0,  0, 0,  1, 1,  1, 1,  1, 1,  9, 0,  0, 0,  0, 0,  0, 0,  0, 0,  0, 0,  0, 0, 26,26,  0, 0,  0, 0,  0, 0,  0, 0,},
{ 0, 0,  0, 0,  0, 0,  0, 0,  0, 0,  0, 0,  0, 0,  0, 0,  0, 0,  0, 0,  1, 1,  9, 0,  0, 0,  0, 0,  0, 0,  0, 0,  0, 0,  0, 0,  0, 0,  1, 1,  1, 1,  1, 1,  1, 1,  0, 0,  0, 0,},
{ 0, 0,  0, 0,  0, 0,  7, 8,  9,10, 11,12, 13,14, 15,16, 17,18,  0, 0,  2, 2,  2, 2,  2, 2,  2,11,  0, 0,  0, 0,  0, 0,  0, 0,  0, 0,  0, 0, 26,26,  0, 0,  0, 0,  0, 0,  0, 0,},
{ 0, 0,  1, 1,  0, 0,  0, 0,  0, 0,  0, 0,  0, 0,  0, 0,  1, 1,  0, 0,  1, 1,  9, 0,  0, 0,  0, 0,  0, 0,  0, 0,  0, 0,  0, 0,  0, 0,  1, 1,  1, 1,  1, 1,  1, 1,  0, 0,  1, 1,},
{ 0, 0,  2, 2,  0, 0,  0, 0,  0, 0,  0, 0,  0, 0,  0, 0,  2, 2,  0, 0,  2, 2,  2,11,  0, 0,  0, 0,  0, 0,  0, 0,  0, 0,  0, 0,  0, 0,  2, 2,  2, 2,  2, 2,  2, 2,  0, 0,  2, 2,},
};

uint16_t Level_00_Items[] = {

63,                             // ItemType::Puff
0,                             // Position X
0,                             // Position Y
255,                             // Frame
0,                             // Data
0,                             // Counter
};

uint16_t Level_00_Enemies[] = {
3                            // EnemyType::SwordFighter
240,                             // Position X
0,                             // Position Y
1051,                             // Stance::Enemy_Sword_Stationary_LH
50,                             // Inventory ItemType::Glint_Hidden
0,                              // Data

0                            // EnemyType::None
0,                             // Position X
0,                             // Position Y
0,                             // Stance::Enemy_None
0,                             // Inventory ItemType::None
0,                             // IData

0                            // EnemyType::None
0,                             // Position X
0,                             // Position Y
0,                             // Stance::Enemy_None
0,                             // Inventory ItemType::None
0,                             // IData

0                            // EnemyType::None
0,                             // Position X
0,                             // Position Y
0,                             // Stance::Enemy_None
0,                             // Inventory ItemType::None
0,                             // IData
};