uint8_t Level_01[] = {
{ 0, 0,  0, 0,  0, 0, 64,64, 74,74, 74,74, 74,74, 64,64, 74,74, 74,74, 74,74, 64,64, 74,74, 74,74, 74,74, 62,62, 72,72,  0, 0,  0, 0,  0, 0,  0, 0,  0, 0,  0, 0,  0, 0,  0, 0,},
{ 0, 0,  0, 0,  0, 0, 64,64, 74,74, 74,74, 74,74, 64,64, 74,74, 74,74, 74,74, 64,64, 74,74, 74,74, 74,74, 62,62, 72,72,  0, 0,  0, 0,  0, 0,  0, 0,  0, 0,  0, 0,  0, 0,  0, 0,},
{ 0, 0,  0, 0,  0, 0,  1, 1,  0, 0,  0, 0,  0, 0,  0, 0,  0, 0,  0, 0,  0, 0,  0, 0,  0, 0, 33,33,  0, 0, 33,33,  1, 1,  0, 0,  0, 0,  0, 0,  0, 0,  0, 0,  0, 0,  0, 0,  0, 0,},
{ 0, 0,  0, 0,  0, 0,  2, 2,  0, 0,  0, 0,  0, 0,  0, 0,  0, 0,  0, 0,  0, 0,  0, 0,  0, 0, 31,31,  0, 0, 31,31,  2, 2,  0, 0,  0, 0,  0, 0,  0, 0,  0, 0,  0, 0,  0, 0,  0, 0,},
{ 0, 0,  0, 0,  0, 0,  1, 1,  0, 0,  0, 0,  4, 5, 64,64, 74,74, 74,74, 74,74, 62,62, 72,72, 31,31,  1,19, 31,31,  1, 1,  0, 0,  0, 0,  0, 0,  0, 0,  0, 0,  0, 0,  0, 0,  0, 0,},
{ 0, 0,  0, 0,  0, 0,  2, 2,  0, 0,  0, 0,  1, 2, 64,64, 74,74, 74,74, 74,74, 62,62, 72,72, 31,31,  2, 2, 32,32,  2, 2,  0, 0,  0, 0,  0, 0,  0, 0,  0, 0,  0, 0,  0, 0,  0, 0,},
{ 0, 0,  0, 0,  0, 0, 64,64, 74,74, 74,74, 74,74,  0, 0,  0, 0,  0, 0,  0, 0,  1, 1,  0, 0, 31,31,  0, 0,  0, 0,  1, 1,  0, 0,  0, 0,  0, 0,  0, 0,  1, 1,  0, 0,  0, 0,  0, 0,},
{ 0, 0,  0, 0,  0, 0, 64,64, 74,74, 74,74, 74,74,  0, 0,  0, 0,  0, 0,  0, 0,  2, 2,  0, 0, 31,31,  0, 0,  0, 0,  2, 2,  0, 0,  0, 0,  0, 0,  0, 0,  2, 2,  0, 0,  0, 0,  0, 0,},
{ 0, 0,  0, 0,  0, 0,  0, 0,  0, 0,  0, 0,  1, 1, 15,15, 15,15, 15,15, 15,15,  1, 1,  0, 0, 31,31,  0, 0, 21, 1, 62,62, 72,72,  0, 0,  0, 0,  0, 0,  1, 1,  0, 0,  0, 0,  0, 0,},
{ 0, 0,  0, 0,  0, 0,  0, 0,  0, 0,  0, 0,  2, 2,  0, 0,  0, 0,  0, 0,  0, 0,  2, 2,  0, 0, 31,31,  0, 0,  2, 2, 62,62, 72,72,  0, 0,  0, 0,  0, 0,  2, 2,  0, 0,  0, 0,  0, 0,},
{ 1, 1, 15,15, 15,15, 15,15, 15,14,  0, 0,  0, 0,  0, 0,  0, 0,  0, 0,  0, 0,  0, 0,  0, 0, 31,31,  0, 0,  0, 0,  0, 0, 63,63, 73,73, 73,73,  0, 0,  1, 1,  0, 0,  0, 0,  0, 0,},
{ 2, 2,  0, 0,  0, 0,  0, 0,  0,14,  0, 0,  0, 0,  0, 0,  0, 0,  3, 3,  0, 0,  0, 0,  0, 0, 32,32,  0, 0,  0, 0,  0, 0, 63,63, 73,73, 73,73,  0, 0,  2, 2,  0, 0,  0, 0,  0, 0,},
{ 1, 1,  0, 0,  0, 0,  0, 0, 62,62, 72,72,  9,10,  0, 0, 16, 0,  1, 1, 16, 0,  4, 5, 63,63, 73,73, 73,73,  9,10,  0, 0, 26,26,  0, 0,  1, 1,  0, 0,  0, 0,  0, 0,  0, 0, 18,18,},
{ 2, 2,  0, 0,  0, 0,  0, 0, 62,62, 72,72,  2, 1,  1, 1,  1, 1,  2, 2,  1, 1,  1, 2, 63,63, 73,73, 73,73,  2, 1,  0, 0, 26,26,  0, 0,  2, 2,  0, 0,  0, 0,  0, 0,  0, 0, 18,18,},
{ 1, 1,  0, 0, 16, 0,  0, 0,  1, 1, 18,18, 64,64, 74,74, 74,74, 74,74, 64,64, 74,74, 74,74, 74,74, 64,64, 74,74, 74,74, 74,74, 62,62, 72,72,  0, 0,  0, 0,  0, 0,  0, 0, 18,18,},
{ 2, 2,  1, 1,  1, 1,  1, 1,  2, 2, 18,18, 64,64, 74,74, 74,74, 74,74, 64,64, 74,74, 74,74, 74,74, 64,64, 74,74, 74,74, 74,74, 62,62, 72,72,  0, 0,  0, 0,  0, 0,  0, 0, 18,18,},
};

uint16_t Level_01_Items[] = {
41,                             // ItemType::Chakana
432,                             // Position X
16,                             // Position Y
9,                             // Frame
0,                             // Data
0,                             // Counter

0,                             // ItemType::Key1
208,                             // Position X
80,                             // Position Y
0,                             // Frame
0,                             // Data
0,                             // Counter

14,                             // ItemType::LockedDoor
416,                             // Position X
16,                             // Position Y
0,                             // Frame
0,                             // Data
0,                             // Counter

63,                             // ItemType::Puff
0,                             // Position X
0,                             // Position Y
255,                             // Frame
0,                             // Data
0,                             // Counter
};

uint16_t Level_01_Enemies[] = {
0                            // EnemyType::None
0,                             // Position X
0,                             // Position Y
0,                             // Stance::Enemy_None
0,                             // Inventory ItemType::None

0                            // EnemyType::None
0,                             // Position X
0,                             // Position Y
0,                             // Stance::Enemy_None
0,                             // Inventory ItemType::None

0                            // EnemyType::None
0,                             // Position X
0,                             // Position Y
0,                             // Stance::Enemy_None
0,                             // Inventory ItemType::None

0                            // EnemyType::None
0,                             // Position X
0,                             // Position Y
0,                             // Stance::Enemy_None
0,                             // Inventory ItemType::None
};

uint16_t Level_01_PlayerStart[] = {
0,
0,
107,
};