uint8_t Level_00[] = {
{ 0, 0,  0, 0,  0, 0,  0, 0, 43,43,  1, 1,  1, 1,  1, 1,  1, 1,  1, 1,  1, 1,  1, 1,  1, 1,  1, 1,  1, 1,  1, 1,  1, 1,  1, 1, 42,42,  0, 0,  0, 0,  0, 0,  0, 0,  0, 0,  0, 0,},
{ 0, 0,  0, 0,  0, 0,  0, 0, 43,43,  2, 2,  2, 2,  2, 2,  2, 2,  2, 2,  2, 2,  2, 2,  2, 2,  2, 2,  2, 2,  2, 2,  2, 2,  2, 2, 42,42,  0, 0,  0, 0,  0, 0,  0, 0,  0, 0,  0, 0,},
{ 0, 0,  0, 0,  0, 0,  0, 0,  0, 0,  0, 0,  0, 0,  0, 0,  0, 0,  0, 0, 33,33,  0, 0,  0, 0,  0, 0,  0, 0,  0, 0,  0, 0, 33,33,  0, 0,  0, 0,  0, 0,  0, 0,  0, 0,  0, 0,  0, 0,},
{ 0, 0,  0, 0,  0, 0,  0, 0,  0, 0,  0, 0,  0, 0,  0, 0,  0, 0,  0, 0, 31,31,  0, 0,  0, 0,  0, 0,  0, 0,  0, 0,  0, 0, 31,31,  0, 0,  0, 0,  0, 0,  0, 0,  0, 0,  0, 0,  0, 0,},
{ 0, 0,  0, 0,  0, 0,  0, 0,  0, 0,  0, 0,  0, 0,  0, 0,  0, 0,  0, 0, 31,31,  1, 1,  1, 1,  1, 1,  1, 1,  1, 1,  1, 1, 31,31,  0, 0,  0, 0,  0, 0,  0, 0,  0, 0,  0, 0,  0, 0,},
{ 0, 0,  0, 0,  0, 0,  0, 0, 29, 0,  0, 0,  0,30,  0, 0,  0, 0,  0, 0, 31,31,  2, 2,  2, 2,  2, 2,  2, 2,  2, 2,  2, 2, 31,31,  0, 0,  0, 0,  0, 0,  0, 0,  0, 0,  0, 0,  0, 0,},
{ 0, 0,  0, 0,  1, 1,  1, 1,  0, 0,  0, 0,  0, 0,  1, 1,  1, 1,  1, 1, 31,31,  0, 0,  0, 0,  0, 0,  0, 0,  0, 0,  0, 0, 31,31,  0, 0,  0, 0,  0, 0,  0, 0,  0, 0,  0, 0,  0, 0,},
{ 0, 0,  0, 0,  2, 2,  2, 2,  0, 0,  0, 0,  0, 0,  2, 2,  2, 2,  2, 2, 31,31,  0, 0,  0, 0,  0, 0,  0, 0,  0, 0,  0, 0, 31,31,  0, 0,  0, 0,  0, 0,  0, 0,  0, 0,  0, 0,  0, 0,},
{ 0, 0,  0, 0,  0, 0,  0, 0,  0, 0,  0, 0,  0, 0,  0, 0,  0, 0,  0, 0, 31,31,  0, 0,  0, 0,  0, 0,  0, 0,  0, 0,  0, 0, 31,31,  0, 0,  0, 0,  0, 0,  0, 0,  0, 0,  0, 0,  0, 0,},
{ 0, 0,  0, 0,  0, 0,  0, 0,  0, 0,  0, 0,  0, 0,  0, 0,  0, 0,  0, 0, 32,32,  0, 0,  0, 0,  0, 0,  0, 0,  0, 0,  0, 0, 32,32,  0, 0,  0, 0,  0, 0,  0, 0,  0, 0,  0, 0,  0, 0,},
{ 0, 0,  0, 0,  0, 0,  0, 0,  0, 0,  0, 0,  0, 0,  0, 0,  0, 0,  0, 5,  1, 1,  9, 0,  0, 0,  0, 0,  0, 0,  0, 0,  0, 0,  0, 0,  0, 0,  1, 1,  1, 1,  1, 1,  0, 0,  0, 0,  0, 0,},
{ 0, 0,  0, 0,  0, 0,  0, 0,  0, 0,  0, 0,  0, 0,  0, 0,  0, 0,  6, 2,  2, 2,  2,11,  0, 0,  0, 0,  0, 0,  0, 0,  0, 0,  0, 0,  0, 0,  2, 2,  2, 2,  2, 2,  0, 0,  0, 0,  0, 0,},
{ 0, 0,  0, 0,  0, 0,  0, 0,  0, 0,  0, 0,  0, 0,  0, 5,  1, 1,  1, 1,  1, 1,  1, 1,  1, 1,  9, 0,  0, 0,  0, 0,  0, 0,  0, 0,  0, 0, 26,26,  0, 0,  0, 0,  0, 0,  0, 0,  0, 0,},
{ 0, 0,  0, 0,  0, 0,  0, 0,  0, 0,  0, 0,  0, 0,  6, 2,  2, 2,  2, 2,  2, 2,  2, 2,  2, 2,  2,11,  0, 0,  0, 0,  0, 0,  0, 0,  0, 0, 26,26,  0, 0,  0, 0,  0, 0,  0, 0,  0, 0,},
{ 0, 0,  1, 1,  0, 0,  0, 0,  0, 0,  0, 5,  1, 1,  1, 1,  1, 1,  1, 1,  1, 1,  1, 1,  1, 1,  1, 1,  1, 1,  9, 0,  0, 0,  0, 0,  0, 5,  1, 1,  1, 1,  1, 1,  0, 0,  0, 0,  0, 0,},
{ 1, 1,  2, 2,  1, 1,  0, 0,  0, 0,  6, 2,  2, 2,  2, 2,  2, 2,  2, 2,  2, 2,  2, 2,  2, 2,  2, 2,  2, 2,  2,11,  0, 0,  0, 0,  6, 2,  2, 2,  2, 2,  2, 2,  0, 0,  0, 0,  0, 0,},
};

uint16_t Level_00_Items[] = {
0,                             // ItemType::Key1
176,                             // Position X
80,                             // Position Y
0,                             // Frame
0,                             // Data
0,                             // Counter

14,                             // ItemType::LockedDoor
448,                             // Position X
16,                             // Position Y
0,                             // Frame
0,                             // Data
0,                             // Counter

41,                             // ItemType::Chakana
480,                             // Position X
16,                             // Position Y
9,                             // Frame
0,                             // Data
0,                             // Counter

18,                             // ItemType::Swinging_Vine
208,                             // Position X
96,                             // Position Y
0,                             // Frame
0,                             // Data
0,                             // Counter

59,                             // ItemType::Chakana_Small
160,                             // Position X
16,                             // Position Y
9,                             // Frame
5,                             // Data
0,                             // Counter

63,                             // ItemType::Puff
0,                             // Position X
0,                             // Position Y
255,                             // Frame
0,                             // Data
0,                             // Counter
};

uint16_t Level_00_Enemies[] = {
0                            // EnemyType::None
0,                             // Position X
0,                             // Position Y
0,                             // Stance::Enemy_None
0,                             // Inventory ItemType::None

0                            // EnemyType::None
0,                             // Position X
0,                             // Position Y
0,                             // Stance::Enemy_None
0,                             // Inventory ItemType::None

0                            // EnemyType::None
0,                             // Position X
0,                             // Position Y
0,                             // Stance::Enemy_None
0,                             // Inventory ItemType::None

0                            // EnemyType::None
0,                             // Position X
0,                             // Position Y
0,                             // Stance::Enemy_None
0,                             // Inventory ItemType::None
};