uint8_t Level_02[] = {
{ 1, 1,  0, 0,  1, 1,  0, 0,  0, 0,  0, 0,  0, 0,  0, 0,  0, 0,  0, 0,  0, 0,  0, 0,  0, 0,  0, 0,  0, 0,  0, 0,  0, 0,  0, 0,  0, 0,  0, 0,  0, 0,  0, 0,  0, 0,  0, 0,  0, 0,},
{ 2, 2,  0, 0,  2, 2,  0, 0,  0, 0,  0, 0,  0, 0,  0, 0,  0, 0,  0, 0,  0, 0,  0, 0,  0, 0,  0, 0,  0, 0,  0, 0,  0, 0,  0, 0,  0, 0,  0, 0,  0, 0,  0, 0,  0, 0,  0, 0,  0, 0,},
{33,33, 41,41, 33,33,  0, 0,  4, 5,  1, 1, 20, 0,  0, 0,  0, 0,  0, 0,  0, 0,  0, 0,  4, 5, 27,27, 27,27, 27,27, 27,27,  0, 0, 13,15, 15,15, 15,15, 15,15, 15,15, 15,14,  0, 0,},
{31,31, 41,41, 31,31,  0, 0,  1, 2,  2, 2,  2,20,  0, 0,  0, 0,  0, 0,  0, 6,  1, 1,  1, 2,  2, 2,  2, 2,  2, 2,  2, 2,  0, 0, 13, 0,  0, 0,  0, 0,  0, 0,  0, 0,  0,14,  0, 0,},
{31,31,  1, 1, 31,31,  1, 1, 33,33,  0, 0, 64,64, 74,74, 74,74, 74,74,  1, 1,  0, 0,  0, 0,  0, 0,  0, 0,  0, 0,  0, 0,  0, 0, 18,18,  0, 0,  0, 0,  0, 0,  0, 0,  1, 1,  0, 0,},
{31,31,  2, 2, 31,31,  2, 2, 31,31,  0, 0, 64,64, 74,74, 74,74, 74,74,  2, 2,  0, 0,  0, 0,  0, 0,  0, 0,  0, 0,  0, 0,  0, 0, 18,18,  0, 0,  0, 0,  0, 0,  0, 0,  2, 2,  0, 0,},
{31,31,  0, 0, 31,31,  0, 0, 31,31,  0, 0,  0, 0,  0, 0,  0, 0,  0, 0,  0, 0,  0, 0,  0, 0,  0, 0, 28,28, 28,28, 28,28, 28,28,  0, 0,  0, 0,  0, 0,  0, 0,  0, 0,  0, 0,  0, 0,},
{31,31,  0, 0, 32,32,  0, 0, 31,31,  0, 0,  0, 0,  0, 0,  0, 0,  0, 0,  0, 0,  0, 0,  0, 0,  0, 0,  2, 2,  2, 2,  2, 2,  2, 2,  0, 0,  0, 0,  0, 0,  0, 0,  0, 0,  0, 0,  0, 0,},
{31,31,  4, 5,  1, 1,  9,10, 31,31,  0, 0,  0, 0,  0, 0,  0, 0,  0, 0,  0, 0,  0, 0,  0, 0,  0, 0,  0, 0,  0, 0,  0, 0,  0, 0,  0, 0,  0,17,  2, 2,  2, 2, 62,62, 72,72,  0, 0,},
{32,32,  1, 2,  2, 2,  2, 1, 32,32,  0, 0,  0, 0,  0, 0,  0, 0,  0, 0,  0, 0,  0, 0,  0, 0,  0, 0,  0, 0,  0, 0,  0, 0,  0, 0,  0, 0,  1, 1,  3, 3,  3, 3, 62,62, 72,72,  0, 0,},
{64,64, 74,74, 74,74, 74,74, 62,62, 72,72,  0, 0,  0, 0,  0, 0,  9,10,  0, 0,  0, 0,  0, 0, 27,27, 27,27, 27,27, 27,27, 27,27, 27,27,  1, 1,  0, 0,  0, 0,  0, 0,  0, 0,  0, 0,},
{64,64, 74,74, 74,74, 74,74, 62,62, 72,72, 38,38, 39,39, 40,40,  2, 1,  0, 0,  0, 0,  0, 0,  2, 2,  2, 2,  2, 2,  2, 2,  2, 2,  2, 2,  2, 2,  0, 0,  0, 0,  0, 0,  0, 0,  0, 0,},
{ 0, 0,  0, 0,  0, 0,  0, 0,  0, 0, 64,64, 74,74, 74,74, 74,74,  1, 1,  9,10,  0, 0,  0, 0,  0, 0,  0, 0,  0, 0,  0, 0,  0, 0,  0, 0,  0, 0,  0, 0,  0, 0,  0, 0,  0, 0,  0, 0,},
{ 0, 0,  0, 0,  0, 0,  0, 0,  0, 0, 64,64, 74,74, 74,74, 74,74,  2, 2,  2, 1,  0, 0,  0, 0,  0, 0,  0, 0,  0, 0,  0, 0,  0, 0,  0, 0,  0, 0,  0, 0,  0, 0,  0, 0,  0, 0,  0, 0,},
{ 0, 0,  0, 0,  0, 0,  0, 0,  0, 0,  0, 0,  0, 0,  0, 0,  0, 0, 62,62, 72,72,  9,10,  0, 0,  0, 0,  0, 0,  0, 0,  0, 0,  0, 0,  0, 0,  0, 0,  0, 0, 18,18,  0, 0,  0, 0,  0, 0,},
{ 0, 0,  0, 0,  0, 0,  0, 0,  0, 0,  0, 0,  0, 0,  0, 0,  0, 0, 62,62, 72,72,  2, 1,  0, 0,  0, 0,  0, 0,  0, 0,  0, 0,  0, 0,  0, 0,  0, 0,  1, 1, 18,18,  1, 1,  0, 0,  0, 0,},
};

uint16_t Level_02_Items[] = {
61,                             // ItemType::Poker
160,                             // Position X
96,                             // Position Y
0,                             // Frame
0,                             // Data
0,                             // Counter

51,                             // ItemType::LifeSaver
480,                             // Position X
16,                             // Position Y
0,                             // Frame
0,                             // Data
0,                             // Counter

41,                             // ItemType::Chakana
512,                             // Position X
64,                             // Position Y
9,                             // Frame
0,                             // Data
0,                             // Counter

12,                             // ItemType::Potion
512,                             // Position X
0,                             // Position Y
0,                             // Frame
0,                             // Data
0,                             // Counter

63,                             // ItemType::Puff
0,                             // Position X
0,                             // Position Y
255,                             // Frame
0,                             // Data
0,                             // Counter
};

uint16_t Level_02_Enemies[] = {
1                            // EnemyType::Archer
178,                             // Position X
0,                             // Position Y
944,                             // Stance::Enemy_Walk_Bow_LH_00
23,                             // Inventory ItemType::Arrow_LH_Hidden

3                            // EnemyType::SwordFighter
258,                             // Position X
96,                             // Position Y
975,                             // Stance::Enemy_Sword_Stationary_LH
50,                             // Inventory ItemType::Glint_Hidden

0                            // EnemyType::None
0,                             // Position X
0,                             // Position Y
0,                             // Stance::Enemy_None
0,                             // Inventory ItemType::None

0                            // EnemyType::None
0,                             // Position X
0,                             // Position Y
0,                             // Stance::Enemy_None
0,                             // Inventory ItemType::None
};