uint8_t Level_00[] = {
{ 0, 0,  0, 0,  0, 0,  0, 0,  0, 0,  0, 0,  0, 0,  0, 0,  0, 0,  0, 0,  0, 0,  0, 0,  0, 0,  0, 0,  0, 0,  0, 0,  0, 0,  0, 0,  0, 0,  0, 0,  0, 0,  0, 0,  0, 0,  0, 0,  0, 0,},
{ 0, 0,  0, 0,  0, 0,  0, 0,  0, 0,  0, 0,  0, 0,  0, 0,  0, 0,  0, 0,  0, 0,  0, 0,  0, 0,  0, 0,  0, 0,  0, 0,  0, 0,  0, 0,  0, 0,  0, 0,  0, 0,  0, 0,  0, 0,  0, 0,  0, 0,},
{ 0, 0,  0, 0,  0, 0,  0, 0,  0, 0,  0, 0,  0, 0,  1, 1,  0, 0,  1, 1,  9,10,  0, 0,  0, 0,  0, 0,  0, 0,  0, 0,  0, 0,  0, 0,  0, 0,  0, 0,  0, 0,  0, 0,  0, 0,  0, 0,  0, 0,},
{ 0, 0,  0, 0,  0, 0,  0, 0,  0, 0,  0, 0,  0, 0,  2, 2,  0, 0,  2, 2,  2, 1,  0, 0,  0, 0,  0, 0,  0, 0,  0, 0,  0, 0,  0, 0,  0, 0,  0, 0,  0, 0,  0, 0,  0, 0,  0, 0,  0, 0,},
{ 0, 0,  0, 0,  0, 0,  0, 0, 36,37, 34,35,  1, 1,  0, 0,  0, 0,  0, 0, 62,62, 72,72,  0, 0, 63,63, 73,73, 73,73,  0, 0,  0, 0,  0, 0,  0, 0,  0, 0,  0, 0,  0, 0,  0, 0,  0, 0,},
{ 0, 0,  0, 0,  0, 0,  0, 0, 36,37, 34,35,  2, 2,  0, 0,  0, 0,  0, 0, 62,62, 72,72,  0, 0, 63,63, 73,73, 73,73,  0, 0,  0, 0,  0, 0,  0, 0,  0, 0,  0, 0,  0, 0,  0, 0,  0, 0,},
{ 0, 0,  0, 0, 63,63, 73,73, 73,73,  8, 8,  1, 1,  0, 0,  0, 0,  0, 0,  0, 0,  0, 0,  0, 0,  0, 0,  0, 0,  0, 0,  0, 0,  0, 0,  0, 0,  0, 0,  0, 0,  0, 0,  0, 0,  0, 0,  0, 0,},
{ 0, 0,  0, 0, 63,63, 73,73, 73,73, 12,12,  2, 2,  0, 0,  0, 0,  0, 0,  0, 0,  0, 0,  0, 0,  0, 0,  0, 0,  0, 0,  0, 0,  0, 0,  0, 0,  0, 0,  0, 0,  0, 0,  0, 0,  0, 0,  0, 0,},
{ 0, 0,  0, 0,  0, 0,  0, 0,  0, 0, 12,12,  1, 1,  0, 0,  0, 0,  0, 0,  0, 0, 62,62, 72,72,  0, 0,  0, 0,  0, 0,  0, 0,  0, 0,  0, 0,  0, 0,  0, 0,  0, 0,  0, 0,  0, 0,  0, 0,},
{ 0, 0,  0, 0,  0, 0,  0, 0,  0, 0, 12,12,  2, 2,  0, 0,  0, 0,  0, 0,  0, 0, 62,62, 72,72,  0, 0,  0, 0,  0, 0,  0, 0,  0, 0,  0, 0,  0, 0,  0, 0,  0, 0,  0, 0,  0, 0,  0, 0,},
{ 0, 0,  0, 0, 63,63, 73,73, 73,73, 12,12,  1, 1,  0, 0,  0, 0,  0, 0,  0, 0,  0, 0,  0, 0,  0, 0,  0, 0,  0, 0,  0, 0,  0, 0, 62,62, 72,72,  0, 0,  0, 0,  0, 0,  0, 0,  0, 0,},
{ 0, 0,  0, 0, 63,63, 73,73, 73,73, 12,12,  2, 2,  0, 0,  0, 0,  0, 0,  0, 0,  0, 0,  0, 0,  0, 0,  0, 0,  0, 0,  0, 0,  0, 0, 62,62, 72,72,  0, 0,  0, 0,  0, 0,  0, 0,  0, 0,},
{ 0, 0,  0, 0,  0, 0,  0, 0,  0, 0, 12,12,  1, 1,  0, 0,  0, 0,  0, 0,  0, 0,  1, 1,  9,10,  0, 0,  0, 0,  0, 0,  0, 0,  0, 0,  0, 0,  0, 0,  0, 0,  0, 0,  0, 0,  0, 0,  0, 0,},
{ 0, 0,  0, 0,  0, 0,  0, 0,  0, 0,  7, 7,  2, 2,  0, 0,  0, 0,  0, 0,  0, 0,  2, 2,  2, 1,  0, 0,  0, 0,  0, 0,  0, 0,  0, 0,  0, 0,  0, 0,  0, 0,  0, 0,  0, 0,  0, 0,  0, 0,},
{ 4, 5, 64,64, 74,74, 74,74, 74,74, 62,62, 72,72,  0, 0,  0, 0,  0, 0,  0, 0,  0, 0, 62,62, 72,72,  0, 0,  0, 0,  0, 0, 64,64, 74,74, 74,74, 74,74,  1, 1,  0, 0,  0, 0,  0, 0,},
{ 1, 2, 64,64, 74,74, 74,74, 74,74, 62,62, 72,72,  0, 0,  0, 0,  0, 0,  0, 0,  0, 0, 62,62, 72,72,  0, 0,  0, 0,  0, 0, 64,64, 74,74, 74,74, 74,74,  2, 2,  0, 0,  0, 0,  0, 0,},
};

uint16_t Level_00_Items[] = {
41,                             // ItemType::Chakana
176,                             // Position X
80,                             // Position Y
9,                             // Frame
0,                             // Data
0,                             // Counter

44,                             // ItemType::Lever_RH
176,                             // Position X
48,                             // Position Y
0,                             // Frame
2,                             // Data
0,                             // Counter

44,                             // ItemType::Lever_RH
160,                             // Position X
16,                             // Position Y
0,                             // Frame
3,                             // Data
0,                             // Counter

46,                             // ItemType::Lever_Portal_Open
224,                             // Position X
80,                             // Position Y
9,                             // Frame
0,                             // Data
0,                             // Counter

47,                             // ItemType::Lever_Portal_Auto_Closed
208,                             // Position X
80,                             // Position Y
0,                             // Frame
1024,                             // Data
0,                             // Counter

63,                             // ItemType::Puff
0,                             // Position X
0,                             // Position Y
255,                             // Frame
0,                             // Data
0,                             // Counter
};

uint16_t Level_00_Enemies[] = {
0                            // EnemyType::None
0,                             // Position X
0,                             // Position Y
0,                             // Stance::Enemy_None
0,                             // Inventory ItemType::None

0                            // EnemyType::None
0,                             // Position X
0,                             // Position Y
0,                             // Stance::Enemy_None
0,                             // Inventory ItemType::None

0                            // EnemyType::None
0,                             // Position X
0,                             // Position Y
0,                             // Stance::Enemy_None
0,                             // Inventory ItemType::None

0                            // EnemyType::None
0,                             // Position X
0,                             // Position Y
0,                             // Stance::Enemy_None
0,                             // Inventory ItemType::None
};