uint8_t Level_00[] = {
{ 0, 0,  0, 0,  0, 0,  0, 0,  1, 1,  1, 1,  1, 1,  1, 1,  1, 1,  1, 1,  1, 1,  1, 1,  1, 1,  1, 1,  1, 1,  1, 1,  1, 1,  1, 1,  0, 0,  0, 0,  0, 0,  0, 0,  0, 0,  0, 0,  0, 0,},
{ 0, 0,  0, 0,  0, 0,  0, 0,  2, 2,  2, 2,  2, 2,  2, 2,  2, 2,  2, 2,  2, 2,  2, 2,  2, 2,  2, 2,  2, 2,  2, 2,  2, 2,  2, 2,  0, 0,  0, 0,  0, 0,  0, 0,  0, 0,  0, 0,  0, 0,},
{ 0, 0,  0, 0,  0, 0,  0, 0,  1, 1,  1, 1,  1, 1,  0, 0,  0, 0,  0, 0,  1, 1,  1, 1,  1, 1,  0, 0,  0, 0,  0, 0,  0, 0,  1, 1,  1, 1,  1, 1,  0, 0,  0, 0,  0, 0,  0, 0,  0, 0,},
{ 0, 0,  0, 0,  0, 0,  0, 0,  2, 2,  2, 2,  2, 2,  0, 0,  0, 0,  0, 0,  2, 2,  2, 2,  2, 2,  0, 0,  0, 0,  0, 0,  0, 0,  2, 2,  2, 2,  2, 2,  0, 0,  0, 0,  0, 0,  0, 0,  0, 0,},
{ 0, 0,  0, 0,  0, 0,  0, 0,  1, 1,  1, 1,  0, 0,  0, 0,  0, 0,  0, 0,  0, 0,  1, 1,  1, 1,  0, 0,  1, 1,  1, 1,  1, 1,  1, 1,  0, 0,  1, 1,  0, 0,  0, 0,  0, 0,  0, 0,  0, 0,},
{ 0, 0,  0, 0,  0, 0,  0, 0,  2, 2,  2, 2,  0, 0,  0, 0,  0, 0,  0, 0,  0, 0,  2, 2,  2, 2,  0, 0,  2, 2,  2, 2,  2, 2,  2, 2,  0, 0,  2, 2,  0, 0,  0, 0,  0, 0,  0, 0,  0, 0,},
{ 0, 0,  0, 0,  0, 0,  0, 0,  1, 1,  0, 0,  0, 0,  0, 0,  0, 0,  0, 0,  0, 0,  0, 0,  1, 1,  0, 0,  0, 0,  0, 0,  0, 0,  0, 0,  0, 0,  1, 1,  0, 0,  0, 0,  0, 0,  0, 0,  0, 0,},
{ 0, 0,  0, 0,  0, 0,  0, 0,  2, 2,  0, 0,  0, 0,  0, 0,  0, 0,  0, 0,  0, 0,  0, 0,  2, 2,  0, 0,  0, 0,  0, 0,  0, 0,  0, 0,  0, 0,  2, 2,  0, 0,  0, 0,  0, 0,  0, 0,  0, 0,},
{ 0, 0,  0, 0,  0, 0,  0, 0,  0, 0,  0, 0,  0, 0,  0, 0,  0, 0,  0, 0,  0, 0,  0, 0,  0, 0,  0, 0,  1, 1,  1, 1,  1,19,  0, 0, 21, 1,  1, 1,  0, 0,  0, 0,  0, 0,  0, 0,  0, 0,},
{ 0, 0,  0, 0,  0, 0,  0, 0,  0, 0,  0, 0,  0, 0,  0, 0,  0, 0,  0, 0,  0, 0,  0, 0,  0, 0,  0, 0,  2, 2,  2, 2,  2, 2,  0, 0,  2, 2,  2, 2,  0, 0,  0, 0,  0, 0,  0, 0,  0, 0,},
{ 0, 0,  0, 0,  0, 0,  0, 0,  0, 0,  0, 0,  0, 0,  0, 0,  0, 0,  0, 0,  0, 0,  0, 0,  0, 0,  0, 0,  0, 0,  0, 0,  0, 0,  0, 0,  0, 0,  0, 0,  0, 0,  0, 0,  0, 0,  0, 0,  0, 0,},
{ 0, 0,  0, 0,  0, 0,  0, 0,  0, 0,  0, 0,  0, 0,  0, 0,  0, 0,  0, 0,  0, 0,  0, 0,  0, 0,  0, 0,  0, 0,  0, 0,  0, 0,  0, 0,  0, 0,  0, 0,  0, 0,  0, 0,  0, 0,  0, 0,  0, 0,},
{ 0, 0,  0, 0,  0, 0,  0, 0,  0, 0,  0, 0,  0, 0,  0, 0,  0, 0,  0, 0,  0, 0,  0, 0,  0, 0,  0, 0,  0, 0,  0, 0,  0, 0,  0, 0,  0, 0,  0, 0,  0, 0,  0, 0,  0, 0,  0, 0,  0, 0,},
{ 0, 0,  0, 0,  0, 0,  0, 0,  0, 0,  0, 0,  0, 0,  0, 0,  0, 0,  0, 0,  0, 0,  0, 0,  0, 0,  0, 0,  0, 0,  0, 0,  0, 0,  0, 0,  0, 0,  0, 0,  0, 0,  0, 0,  0, 0,  0, 0,  0, 0,},
{ 0, 0,  0, 0,  0, 0,  0, 0,  0, 0,  0, 0,  0, 0,  0, 0,  0, 0,  0, 0,  0, 0, 28,28, 28,28,  9,10,  0, 0,  0, 0,  0, 0,  0, 0,  0, 0,  0, 0,  1, 1,  0, 0,  0, 0,  0, 0,  0, 0,},
{ 0, 0,  0, 0,  0, 0,  0, 0,  0, 0, 27,27, 27,27,  1, 1, 28,28, 28,28,  1, 1,  2, 2,  2, 2,  2, 1,  0, 0,  0, 0,  0, 0,  0, 0,  0, 0,  0, 0,  2, 2,  0, 0,  0, 0,  0, 0,  0, 0,},
};

uint16_t Level_00_Items[] = {
59,                             // ItemType::Puff
0,                             // Position X
0,                             // Position Y
255,                             // Frame
0,                             // Data
0,                             // Counter
};

uint16_t Level_00_Enemies[] = {
0                            // EnemyType::None
0,                             // Position X
0,                             // Position Y
0,                             // Stance::Enemy_None
0,                             // Inventory ItemType::None

0                            // EnemyType::None
0,                             // Position X
0,                             // Position Y
0,                             // Stance::Enemy_None
0,                             // Inventory ItemType::None

0                            // EnemyType::None
0,                             // Position X
0,                             // Position Y
0,                             // Stance::Enemy_None
0,                             // Inventory ItemType::None
};











    uint16_t Level_00_PlayerStart[] = {
        0,                              // Position X 
        0,                              // Position Y
        107,                            // Stance::Man_Walk_RH_00
//        479,                            // Stance::Man_Walk_LH_00
        
    };